23 37
00000000112200000010000
00000000012200000000000
00111000021000200000000
00221112221000000010000
00223330033000000011001
00223110003320000001200
00233130000032223321200
00004333004333003331200
00004440443333303302000
00000344043333344433000
00003333043333440333000
22022333133033000330322
02222213330002200333020
03022201330332124330022
30023343333330144300023
10000343113333334000021
10000034433300334400211
11000033223300043330201
11000033001000433331203
11000333000111043331123
00000333222001033332200
10000333000200443330000
00000333302223433330000
00003333332003333330000
00033334411003333332000
20023332240134333333002
20200331443333333333020
02200333303343333333220
23103002333443334102222
00312304333333004430020
00220331003330013310220
00000013330000011330200
00000100030000222333000
00000100003002200011000
00001000002120000010000
00000000000220000001000
00000000002200000010000
