37 23
0000100000020231113300000200200000000
0000000000022222100200000022222000000
0000022200030000222120000002202200000
0000111123303000001120002333200031010
1001102303333300033333333333031331101
0000003334333330433333333333143330000
0000003334000444433333333333443120000
0000002004400243343434333333301120000
0020002033402113304004433333300022000
0000002333332203000110333433330002000
0000023333330333000100200334433000220
2200030333300333330102200133433000122
2211330433330033331020221033333003202
1122300044433331320020031440330330000
1002000040013331420020334243330300000
0002000304333133433333334213241300000
0001313344331044333333333333003100000
0001311343332233000333333333033011000
0011333440322230000000033300320000100
0012223000022220000000003200012000000
0012222000002000000000000022132000000
0000000000022300011100000002300000000
0000000000020031111101000220200000000
